1111001111
1000000001
1020002001
1000000001
1000000001
1000000001
1000000001
1000000301
1000000001
1111111111