77744AAAAA
1111444AAA
1155154444
5533355553
5500515000
6656005354
5556635555
5550055555
5555333555
5355355535
